0	0	0	5	1	0	0	0	0	0	0	0	2	2	0	5	0	0	4	4	4
0	0	0	1   1   0   1   0   0	0	0	0	0	0	3	3	3	0	0	0	0	4	4
0	0	5	1	1   1   0   1   1	0	0	0	0	0	0	0	2	2	2	0	0	0	0	0
2	2	2	1   1   1   1   0	1   0   1   0   1	1   0   1   0   1	1   0   1   0   1	1   0   0   1   1	0	0	0	3	3	0	5	0	0	0	0	0
0	0	0	1   1   0   1   0	0	2	2	1   1   1   0   0	1   0   1   0   1	1   0   0   1   1	0	0	3	3	1   1   0   1   0	0	5	2	0	0
0	0	0	5	1  	2	0	0	0	0	1   1   1   0   0	1   0   1   0   1	1   0   1   0   1	1   0   1   0   1	1   0   1   0   1	1   1   1   0   1	5	0	1   1   1   0   1   1   0   0   1   1	4
0	0	0	2	0	0	0	0	0	0	2	0	0	0	0	0	0	5	2	5	2
3	0	0	1
0	3	1	1
1	4	3	2
2	7	3	2
3	10	4	1
0	12	5	2
1	16	4	1
2	18	6	1
0	4	0	1
3	16	6	2
